[
  {
    "type": "mapgen",
    "method": "json",
    "//": "ground entrance",
    "om_terrain": [ [ "lizardfolk_lair_z-0_NW", "lizardfolk_lair_z-0_NE" ], [ "lizardfolk_lair_z-0_SW", "lizardfolk_lair_z-0_SE" ] ],
    "object": {
      "predecessor_mapgen": "forest_water",
      "rows": [
        "                                                ",
        "                                                ",
        "                                                ",
        "                                                ",
        "                                                ",
        "                                                ",
        "                                                ",
        "                                                ",
        "                                                ",
        "                                                ",
        "                                                ",
        "                                                ",
        "                            ,,                  ",
        "                        ,                       ",
        "                   , , , ,,,  ,                 ",
        "                 , ,, , , ,  , ,                ",
        "                , , ,,,, , ,,,,,                ",
        "                 ,,,~ ,,~~, , ,,                ",
        "                , ,,  ~~~~  , , , ,             ",
        "              ~~~,~ ~~a~~a~~  ,,  ,,            ",
        "             ~~~ ,,,|||##|||, , ,, , ,          ",
        "              ~~~, ~|######|~~, ~~~, ,          ",
        "            ~~i~i~ ~|#____#|~~~~~~~ ~,          ",
        "            ,,~~~  e|#_>>_#|e~g~~~g~~i,,        ",
        "              ,,~~~~##_>>_##~~g~f~g~~,,         ",
        "             ,,,~~~e|#____#|e~g~~~g~ ,          ",
        "              , ,~~~|######|~~~~~ ~~,,,         ",
        "             ,,,~~~~|||##|||~ ~i~~,,,,          ",
        "            ,,~~i~~~~~a~~a,~  ,~, ,, ,          ",
        "             ,,~~ ~~ ~~~~~~,,, ,, ,,            ",
        "            ,  ,,,  , ,~, , , ,, ,, ,           ",
        "             ,, , ,,,, ,,, ,,,,, ,,             ",
        "           , , ,  , ,, , ,,,, ,,,               ",
        "                 ,    ,,  ,,, ,,                ",
        "                      ,      ,,                 ",
        "                                                ",
        "                                                ",
        "                                                ",
        "                                                ",
        "                                                ",
        "                                                ",
        "                                                ",
        "                                                ",
        "                                                ",
        "                                                ",
        "                                                ",
        "                                                ",
        "                                                "
      ],
      "flags": [ "ERASE_ALL_BEFORE_PLACING_TERRAIN" ],
      "terrain": {
        "~": "t_sand",
        "f": "t_sand",
        "_": "t_floor_blue",
        "#": "t_floor_green",
        "|": "t_rock_smooth",
        "e": "t_rock_blue",
        "a": "t_rock_green",
        ">": "t_slope_down",
        "<": "t_slope_up",
        "X": "t_rock",
        "g": "t_trunk",
        "i": "t_improvised_shelter"
      },
      "furniture": { "d": "f_boulder_small", "c": "f_boulder_medium", "b": "f_boulder_large", "f": "f_firering" },
      "place_monsters": [
        { "monster": "GROUP_LIZARDFOLK_LAIR", "x": [ 4, 19 ], "y": [ 24, 44 ], "density": 0.1, "repeat": [ 1, 3 ] },
        { "monster": "GROUP_LIZARDFOLK_LAIR", "x": [ 24, 44 ], "y": [ 24, 44 ], "density": 0.1, "repeat": [ 1, 3 ] },
        { "monster": "GROUP_LIZARDFOLK_LAIR", "x": [ 24, 44 ], "y": [ 4, 23 ], "density": 0.1, "repeat": [ 1, 3 ] }
      ],
      "fields": {
        ",": { "field": "fd_fog_permanent", "intensity": 2 },
        "~": { "field": "fd_fog_permanent", "intensity": 2 },
        ">": { "field": "fd_fog_permanent", "intensity": 2 },
        "_": { "field": "fd_fog_permanent", "intensity": 2 },
        "#": { "field": "fd_fog_permanent", "intensity": 2 }
      }
    }
  },
  {
    "type": "mapgen",
    "method": "json",
    "om_terrain": [ [ "lizardfolk_lair_z-1_NW", "lizardfolk_lair_z-1_NE" ], [ "lizardfolk_lair_z-1_SW", "lizardfolk_lair_z-1_SE" ] ],
    "object": {
      "fill_ter": "t_water_sh",
      "rows": [
        "XXXXXXXXXXXXXXXXXXXXXXXXXXXXXXXXXXXXXXXXXXXXXXXX",
        "XXXXXXXXXXXXXXXXXXXXXXXXXXXXXXXXXXXXXXXXXXXXXXXX",
        "XXXX,,,,,,,XXXX,,,,,,,,,,,,,,,,XXXXXX,,,,,,.XXXX",
        "XX,,,,,,,,,,XX,,,,,,,,,,,,,,,,,,XXXX,,,,,,,,,,XX",
        "XX,,,,,,,,,,XX,,,,,,,,,,,,,,,,,XXXX,,,,,,,,,,,XX",
        "XXXX,,,,,,,,,XX,,,,,,,,,,,,,,,,,XX,,,,,,,,,,,,XX",
        "XXXXXX,,,,,,,,XX,,,,,,,,,,,,,,,XX,,,,,,,,,,,,,XX",
        "XXXX.,,,,,,,,,,,,,,,,,,,,,,,,,XXXX,,,,,,,,,,,,XX",
        "XX,,,,,,,,,,,,,,,,,,,,,,,,,,,,,XX,,,,,,,,,,,,,XX",
        "XX,,,,,,,,,,,,,,,,,,,,,,,,,,,,,XX,,,,,,,,,,,,,XX",
        "XX,,,,,,,,,,,,,,,,,,,,,,,,,,,,,XX,,,,,,,,,,,,,XX",
        "XXXX,,,,,,,,,,,,,,,,,,,,,,,,,,,XX,,,,,,,,,,,,,XX",
        "XXX,XXXX,,,,,,,,,,,,,,,,,,,,,,,,XX,,,,,,,,,,XXXX",
        "XXX,XXXXXX..,,,,..,..,..,,,,,..XXXX,,,,,,,XXXXXX",
        "XXX,,XXXXXXX.,.,..........,.....XXXX,,,,,XXXXXXX",
        "XXX,.XXXXXX....,...................XX,,,,.XXXXXX",
        "XXXX..XXXX..........................XX,,,,,XXXXX",
        "XXXXX.XX.............................XX,,,,.XXXX",
        "XXXX.................................XX,,,,,,.XX",
        "XX..................................XX..,.,,,.XX",
        "XX.................................XX,,,,,,,..XX",
        "XX..................................XX,,,,,,..XX",
        "XX....................    ...........XX,,..,,.XX",
        "XX..................   <<   ..............,,.,XX",
        "XX..................   <<   ............,,,,..XX",
        "XX....................    ................,,,,XX",
        "XXXX................................,,,,,..,,,XX",
        "XXXXXX.........................,,.,.,..,,,.,,,XX",
        "XXXXXX,,,,.....................,,.,,.,..,,,,,.XX",
        "XXXX,,,,,,,.....,,.........,..,......,,,,,...XXX",
        "XX,,,,,,,,,,,,,..,,,..,......,,,,,.,,,,,..XXXXXX",
        "XX,,,,,,,,,,,,,,,,,,,,.,..,,,,,,,.,,,,,,,XXXXXXX",
        "XX,,,,,,,,,,,,,,,,,,,..,,.,,,,,,,,..XXX,XXX,XXXX",
        "XX,,,,,,,,,,,,,,,,,,.,,..,,,,.,.,,..XXX,XX,,,XXX",
        "XX,,,,,,,,,,,,,,,,,,,,,,,,,,.,,,,,.XXXX,,,,,,XXX",
        "XX,,,,,,,,,,,,,,,,,,,,,,..,,.,,.,XXXXXXXXX,,,XXX",
        "XXXX,,,,,,,,,,,,,,,,,,,,,,,,,,...XXXXXXXXXX,XXXX",
        "XXXXXX,,,,,,,,,,,,,,,,,,,,,,,,,XXXXXXXXXXXX,XXXX",
        "XXXXXXXXX,,,,,,,,,,,,,,,X,,,,,,,,,,,,,XXXXX,,XXX",
        "XXXXXXXXXX,,,,,,,,,,,,,XX,,,,,,,,,,,,,,,XXXX,XXX",
        "XXXXXXXXXXX,,,,,,XXXXXXXX,,,,,,,,,,,,,,,,XXXXXXX",
        "XXXXXXX,,,,,,,,,,,,,XXXXXX,,,,,,,,,,,,,,,,,,XXXX",
        "XXXXXXX,,,,,,,,,,,,,,XXXXX,,,,,,,,,,,,,,,,,,,XXX",
        "XXXXXXX,,,,,,,,,,,,XXXXXXXXX,,,,,,,,,,,,,,,,,XXX",
        "XXXXXXXXX,,,,,,,,,,,,XXXXXX,,,,,,,,,,,,XXX,,,XXX",
        "XXXXXXXXXX,,,,,,,,,,XXXXXXXX,,,,,XXXXXXXXXXXXXXX",
        "XXXXXXXXXXXXXXXXXXXXXXXXXXXXXXXXXXXXXXXXXXXXXXXX",
        "XXXXXXXXXXXXXXXXXXXXXXXXXXXXXXXXXXXXXXXXXXXXXXXX"
      ],
      "place_monster": [
        { "group": "GROUP_LIZARDFOLK_LAIR_DEPTHS", "x": [ 4, 23 ], "y": [ 4, 23 ], "chance": 50, "repeat": [ 4, 10 ] },
        {
          "group": "GROUP_LIZARDFOLK_LAIR_DEPTHS",
          "x": [ 4, 19 ],
          "y": [ 24, 44 ],
          "chance": 50,
          "repeat": [ 4, 10 ]
        },
        {
          "group": "GROUP_LIZARDFOLK_LAIR_DEPTHS",
          "x": [ 24, 44 ],
          "y": [ 24, 44 ],
          "chance": 50,
          "repeat": [ 4, 10 ]
        },
        {
          "group": "GROUP_LIZARDFOLK_LAIR_DEPTHS",
          "x": [ 24, 44 ],
          "y": [ 4, 23 ],
          "chance": 50,
          "repeat": [ 4, 10 ]
        },
        {
          "group": "GROUP_LIZARDFOLK_LAIR_DEPTHS",
          "x": [ 10, 23 ],
          "y": [ 10, 23 ],
          "chance": 50,
          "repeat": [ 4, 10 ]
        }
      ],
      "terrain": {
        ">": "t_slope_down",
        "<": "t_slope_up",
        "X": "t_soil",
        " ": "t_sand",
        "~": "t_water_dp_underground",
        ".": [
          [ "t_grass_tall", 5 ],
          [ "t_stump", 1 ],
          [ "t_pit_shallow", 2 ],
          [ "t_pit_spiked", 2 ],
          [ "t_pit_glass", 2 ],
          [ "t_grass_long", 5 ],
          [ "t_water_murky", 25 ],
          [ "t_water_sh_underground", 25 ],
          [ "t_swater_sh_underground", 25 ],
          [ "t_sand_underground", 3 ],
          [ "t_water_dp_underground", 40 ],
          [ "t_moss_underground", 10 ],
          [ "t_underbrush", 3 ],
          [ "t_dirt_underground", 2 ],
          [ "t_mud_underground", 2 ],
          "t_shrub"
        ],
        ",": [
          [ "t_grass_tall", 5 ],
          [ "t_stump", 1 ],
          [ "t_pit_shallow", 2 ],
          [ "t_pit_spiked", 2 ],
          [ "t_pit_glass", 2 ],
          [ "t_grass_long", 5 ],
          [ "t_water_murky", 25 ],
          [ "t_water_sh_underground", 25 ],
          [ "t_swater_sh_underground", 25 ],
          [ "t_sand_underground", 3 ],
          [ "t_water_dp_underground", 40 ],
          [ "t_moss_underground", 10 ],
          [ "t_underbrush", 3 ],
          [ "t_dirt_underground", 2 ],
          [ "t_mud_underground", 2 ],
          "t_shrub"
        ]
      },
      "furniture": { "a": "f_boulder_small", "c": "f_boulder_medium", "b": "f_boulder_large", "1": "f_table", "2": "f_swamp_gas" },
      "items": {
        ".": [ { "item": "lair_lizardfolk_depths", "chance": 5 } ],
        ",": [ { "item": "lair_lizardfolk_depths", "chance": 5 } ]
      },
      "fields": {
        ",": { "field": "fd_fog_permanent", "intensity": 2 },
        ">": { "field": "fd_fog_permanent", "intensity": 2 },
        "<": { "field": "fd_fog_permanent", "intensity": 2 },
        " ": { "field": "fd_fog_permanent", "intensity": 2 }
      }
    }
  }
]
